11111111111111111111111111111111111111111
10000000000000000000000000000000000000001
10000110001111111000111111100111111110001
1000111000000C110000000C11000000001110001
10010110000011100000001110000000001110001
10100110000000110000000011000000001110001
1000P110000000C110000000C1100000001110001
10011111000111111000011111100000001110001
1000000000000000000000000000000000000E001
11111111111111111111111111111111111111111