1111111111111111111111111111111111
10000000000000000000000C0000000001
1000010001111110011111100111110001
100011000C000110000001100000E10001
1001010000011100000111000000010001
10100100000001100000011000C0010001
1000P10000000010000C00100000010001
1001111100111110001111100000010001
1000000000000000000000000000000001
1111111111111111111111111111111111